#	#	5	S	1
3	7	8	6	7
9	4	7	1	4
#	8	#	1	3
2	8	6	#	9
1	1	G	2	2
5	7	#	6	5