#	1	#	7	5	8	6	4
4	6	7	#	#	7	8	6
G	3	2	3	9	8	6	7
2	#	4	3	3	6	3	3
3	#	5	2	5	8	5	6
8	3	2	2	3	9	3	9
7	7	3	5	1	4	6	#
6	3	#	1	9	6	7	1
4	8	#	9	5	7	3	6
4	6	7	#	#	7	8	6
3	3	2	3	9	8	6	7
2	#	4	3	2	6	3	3
3	#	5	2	5	8	5	6
8	3	2	2	3	9	3	9
7	7	3	5	1	4	6	#
6	3	#	1	9	6	7	1
4	8	#	9	5	7	3	S