5	9	4	4	5	1	7	7
#	5	7	1	9	9	4	4
7	7	3	#	8	G	1	8
6	2	3	8	8	4	9	7
9	8	8	7	5	9	3	3
S	3	3	2	4	6	6	4