2	7	4	7	G
4	7	3	2	9
3	1	9	9	2
4	#	3	7	#
4	8	S	2	1
9	8	1	#	8